################
#           #  #
#           #XX#
#  d        #  #
#             @#
#     d        #
#              #
#  d       d   #
#             G#
#    d         #
#              #
#        d     #
#  d           #
#          d   #
#              #
################
