################
#X     @  D    #
#C#         ## #
# #          # #
# #          # #
# #          # #
# #          # #
# #          # #
# #          # #
# #          # #
# #    S     # #
# #          # #
# #          # #
# ############ #
#              #
################
