################
#L     @       #
#      X      G#
#  ooooo########
#              #
#            ss#
#           #ss#
#           #ss#
#           #ss#
#          L#ss#
#           #ss#
#           #ss#
#           #dd#
#        ####dd#
#V       #ddddV#
################
