################
#X     @  D    #
# #  V V D  ## #
# #   D   D  # #
# #       D  # #
# #          # #
# #          # #
# #          # #
# #S         # #
#C#          # #
# #          # #
# #          # #
# #          # #
# ############ #
#              #
################
