################
#X       @   D #
# #  O      ## #
# #  GG      # #
# #          # #
# #          # #
# #          # #
# #          # #
# #          # #
# #          # #
# #          # #
# #        S # #
# #          # #
# ############ #
#              #
################
