################
#X    G@G  GG  #
# #   GLLGGG   #
# #  GGG V   # #
# #          # #
# #          # #
# #          # #
# #          # #
# #          # #
# #          # #
# #          # #
# #          # #
# #          # #
# ############ #
#              #
################
