################
#X     @ L   D #
# #  O         #
# #  GG      # #
# #          # #
# #          # #
# #          # #
# #          # #
# #          # #
# #          # #
# #      C   # #
# #        S # #
# #          # #
# ############ #
#              #
################
