################
#X        OOO  #
# #  V  G ODO# #
# #        G # #
# #        @ # #
# #          # #
#C#          # #
# #          # #
# #          # #
#C#          # #
# #          # #
# #          # #
# #          # #
# ############ #
#              #
################
