################
#      #G#     #
#              #
#              #
#       d      #
#     s       V#
###          ###
#L     XX@    G#
###          ###
#              #
#              #
#   d     dd   #
#   d  V       #
#              #
#     #L#      # 
################
