################
#X     C       #
# #         ## #
# #          # #
# #          # #
# #          # #
# #          # #
# #          # #
# #  @       # #
# #          # #
# #          # #
# #          # #
# #          # #
# ############ #
#              #
################
