################
#X     @       #
# #         ## #
# #          # #
# #          # #
# #          # #
# #      D   # #
# #          # #
# #  C       # #
# #          # #
# #          # #
# # D   D    # #
# #          # #
# ############ #
#              #
################
