################
#X    G@   G   #
# #  OO      C #
# #  GG  V   # #
# #          # #
# #          # #
# #        D # #
# #    O     # #
# #          # #
# #          # #
# #    C     # #
# #        S # #
# #C         # #
# ############ #
#              #
################
