################
#X    G@G  GG  #
# #  OO   GG   #
# #  GG  V   # #
# #          # #
# #          # #
# #        D # #
# #          # #
# #          # #
# #          # #
# #    C     # #
# #        S # #
# #          # #
# ############ #
#              #
################
