################
#X     @       #
# #  V      ## #
# #          # #
# #  O     O # #
# #       O  # #
#O#S  S      # #
# #CS        # #
# #S         # #
#C#          # #
# #          # #
# #          # #
#S#          # #
# ############ #
#              #
################
